11111111111111111111111111111
1C000000000000C000000000000C1
10111111011111111111011111101
100000C100G00000000001C000001
10111101011111C11111010111101
10000101000000000000010100001
10110101011111C11111010101101
10000100000000000000000100001
10110101010111011101010101101
10000001010100C00101010101101
10110101010100E00101010000001
10110101010111111101010101101
10000100000000C0G000000100001
10110101011111011111010101101
10000101000000000000010100001
10111101011111011111010111101
100000C1C00000C0000001C000001
10111111011111111111011111101
1C000000C00000P00000C00000001
11111111111111111111111111111
