1111111
1CCCCC1
1C111C1
1C1E1C1
1C1C1C1
1C1C1C1
1P1CCC1
1111111
