1111111111111111111
1P000C000C000C000E1
1011101011101011101
1C000C000C000C000C1
1011101011101011101
1C000C000C000C000C1
1111111111111111111
