1111111111111111111
1P000C000C000C000E1
1C101C101C101C101C1
1C101C1C1C1C1C1C1C1
1C101C101C101C101C1
1C000C000C000C000C1
1111111111111111111
