111111111111111111111111111111111
1000C00000000000100000000000C00E1
101111110111111010111111011111101
10000000C000000000000000C00000001
101111110101111111111101011111101
1000C00001000000100000010000C0001
111111110111111010111111011111111
100000010100C0000000C001010000001
111111110101111111111101011111111
100000000001000000000100000000001
111111110101000000000101011111111
100000000001000000000100000000001
111111110101111111111101011111111
100000010100C0000000C001010000001
111111110111111010111111011111111
1000C00001P00000100000010000C0001
101111110101111111111101011111101
10000000C000000000000000C00000001
101111110111111010111111011111101
1000C00000000000100000000000C0001
111111111111111111111111111111111
