111111111111111111111111111111111111
10000C0000C0000000011111111011111111
111X11111011000011100000X00000011111
11000C10X000100X0000X000011111000111
10000C0000101110000C0000000011000111
111111101X00C011101111C1110000000111
10000000001011101110000X000000000001
111C11111000001111111110X00111100011
1000000111011011110000C0000100000001
111C011C000X000000110111000111000111
10010011C110111000010000000010001011
1111111000C0010011100111000000010111
111111100000001010000011X00011100001
10000100X000000111101111110001000001
11111111X111011011000000C00100001111
10000C000000010000000001111C00111111
1110101101110111111X1100100000001111
100000000000100111100000000000011001
111101101111100000111111000011000011
10000100000000C0001111X1111110001011
111111101X0000111011111111111C100001
100000000011111000000000000111000001
111111111000001111111100000000001111
1P0000C000000C01001010000000000E1111
111111111111111111111111111111111111
