111111111111111
1E00000000CP0C1
111111111111111
