111111111111111
1P00000000C1E11
111111111111111
