111111111111111
1P00000000C0E11
111111111111111
