11111111
1111PCC1
111110E1
11111111