1111111111
1P0CC000E1
1111011111
1000C00001
1111111111