1111111111
1PCCC01111
1110000CE1
1111111111