1111111111
1P1CC001E1
1111111111
1000C00001
1111111111