111111111111111111111111
1P0000C0000C0000C0000E11
100011111111111111110001
1C00C000X000000X0000C011
100000111111111111000001
111110000C000C0000000001
1X0000000111111111000001
100C000000X0000C000000C1
111111100000000111111111
1C0000C0000C000X0000C001
100011111111111111100001
1C0000C000X0000C0000C0X1
100000000011111100000001
1X000000C000000C00000001
111111111111111111111111
