111111111
1000C0001
1P0000001
100000001
100000001
1E0000001
11C000011
111100111
111111111