1111111
1P0C0E1
1111111
10C0001
1111111