11111111111111
1000XC0P0E0111
11111111111111