1111111
1C111111111
1E11111
1P11111
1X111X1
1111
