111111111111111111111111111111111111
1P000000000X0000000000000000000C00E1
101111111011111011111011111011111101
100000001010001010000010100010000001
101110101011111010111110101111111101
1000101010000000100000001000000X0001
111010101111111011111111101111111101
1C0010100000000010000000010000000C01
111111111011111011111111111111101111
100000000010000000000000000000000001
101111111011111111111011111011111101
100000001000000000010010000010000001
111110101111111111011011111110111101
1C0000100000000000100000000000100001
101111111011101111111111111110111101
1000000X001000000000000000000X00000
111111111111111111111111111111111111
