11111111111111111
1XP000C0000C000E1
11111111111111111
